wwwwwwwwwwwwwwwwwwww
we       e        ew
w  wwwwww wwwwwww  w
w  w  w   w  w  w  w
w                  w
w  w               w
w  w   wwwwww      w
w  w               w
w  w   ~~~~~~      w
w                  w
w                  w
w   wwwwwwww       w
w                  w
w      p   www  p  w
wwwwwwwwwwwwwwwwwwww
