######################
#e   ww   e   ww    e#
#    ww       ww     #
#w wwwww www wwwwww w#
#                    #
#w  wwww     wwwww  w#
#    w         w    w#
#ww ww wwwwwww www ww#
#   w     w      w   #
# www ~~~~w~~~~  www #
#   w     w      w   #
#ww    w     w     ww#
#   w  www www   w   #
# wwww w     w wwwww #
#  w   w www w   w   #
#    p w  f  w p     #
######################