######################
#e   ww   e   ww    e#
#    ww       ww     #
#w wwwww www wwwwww w#
#         w          #
#w  wwww  w  wwwww  w#
#    w         w    w#
#ww ww wwwwwww www ww#
#   wssssswsssss w   #
# wwws~~~~w~~~~s www #
#   wssssswsssss w   #
#ww    w     w     ww#
#ii w  www www   w ss#
#iwwww w     w wwwwws#
#iiw   w www w   wsss#
#iii p w  f  w p  sss#
######################