##########################################
#wwwwwwwwwwwwwwwwwwwwwwwwwwwwwwwwwwwwwwww#
#we       e        e       e        e   w#
#w  wwwwww wwwwwww   wwwwww wwwwwww     w#
#w  w  w   w  w  w   w  w   w  w  w     w#
#w                                      w#
#w  w                w                  w#
#w  w   wwwwww       w   wwwwww         w#
#w  w                w                  w#
#w  w   ~~~~~~       w   ~~~~~~         w#
#w                                      w#
#w                                      w#
#w   wwwwwwww         wwwwwwww          w#
#w                                      w#
#w                                      w#
#w            wwwwwwwww                 w#
#w                                      w#
#w                                      w#
#w  wwwwww wwwwwww   wwwwww wwwwwww     w#
#w  w  w   w  w  w   w  w   w  w  w     w#
#w                                      w#
#w  w         wwwwwwww                  w#
#w  w                w                  w#
#w  w   ~~~~~~       w   ~~~~~~         w#
#w  w                                   w#
#w           wwww    wwww               w#
#w               wwwww                  w#
#w   wwwwwwww  w w f w wwwwwwww         w#
#w             w w   w w                w#
#w      p   wwww p     w p   www  p     w#
#wwwwwwwwwwwwwwwwwwwwwwwwwwwwwwwwwwwwwwww#
##########################################