wwwwwwwwwwwwwwwwwwww
w    e  w w  w  e  w
wwwwww  w e  w www w
w         ww w  ww w
w   ~~~~  ww   ~w  w
w www  w   ~~~~~~ ww
w      w e      w ww
w  ~~~~~~~~~~~  w
w           w  www w
w~~~~~~~~~  w      w
w           www wwww
w   wwwwwwwwwww    w
w   w        w     w
w     p    p       w
wwwwwwwwwwwwwwwwwwww