######################
#wwwwwwwwwwwwwwwwwwww#
#w    e    w     e  w#
#w wwww    w    wwwww#
#w              e   w#
#w   e  w wwww      w#
#w      w           w#
#w      w e         w#
#w     www          w#
#w   wwwwwwww w     w#
#w     e     w      w#
#w                  w#
#w   wwwwwwww       w#
#w              ww  w#
#w      p        p  w#
#wwwwwwwwwwwwwwwwwwww#
######################