######################
#wwwwwwwwwwwwwwwwwwww#
#w    e  w w  w  e  w#
#w~~~~~~~w    w~~~~~w#
#w         ww w  ww w#
#w   ~~~~  ww   ~w  w#
#w www  w   ~~~~~~ ww#
#w      w        w ww#
#w  ~~~~~~~~~~~     w#
#w           w  www w#
#wwwwwwwwww  w      w#
#w           www wwww#
#w                  w#
#w                  w#
#w     p    p       w#
#wwwwwwwwwwwwwwwwwwww#
######################