##########################################
#wwwwwwwwwwwwwwwwwwwwwwwwwwwwwwwwwwwwwwww#
#we       e        e       e        e   w#
#w  wwwwww wwwwwww   wwwwww wwwwwww     w#
#w  w  w   w  w  w   w  w   w  w  w     w#
#w                                      w#
#w  w                w                  w#
#w  w   wwwwww       w   wwwwww         w#
#w  w                w                  w#
#w  w   ~~~~~~       w   ~~~~~~         w#
#w                                      w#
#w                                      w#
#w   wwwwwwww         wwwwwwww          w#
#w                                      w#
#w                                      w#
#w            wwwwwwwww                 w#
#w                                      w#
#w                                      w#
#w  wwwwww wwwwwww   wwwwww wwwwwww     w#
#w  w  w   w  w  w   w  w   w  w  w     w#
#w                                      w#
#w  w                w                  w#
#w  w   wwwwww       w   wwwwww         w#
#w  w                w                  w#
#w  w   ~~~~~~       w   ~~~~~~         w#
#w                                      w#
#w                                      w#
#w   wwwwwwww         wwwwwwww          w#
#w                                      w#
#w      p   www  p       p   www  p     w#
#wwwwwwwwwwwwwwwwwwwwwwwwwwwwwwwwwwwwwwww#
##########################################