######################
#e        e         e#
#                    #
#   wwwwww wwwwwww   #
#   w  w   w  w  w   #
#                    #
#w  w               w#
#w  w   wwwwww      w#
#w  w               w#
#w  w   ~~~~~~      w#
#                    #
#                    #
#    wwwwwwww        #
#                    #
#           www      #
#      p       p     #
######################